orosz vakcina	orosz_vakcina
kínai vakcina	kínai_vakcina
influenza elleni	influenza_elleni
elleni oltás	elleni_oltás
kötelező oltás	kötelező_oltás
orbán viktor	orbán_viktor
influenza oltás	influenza_oltás
bill gates	bill_gates
lélegeztető gép	lélegeztető_gép
oltási terv	oltási_terv
krónikus beteg	krónikus_beteg
magyar ember	magyar_ember
fél év	fél_év
pfizer vakcina	pfizer_vakcina
elleni védőoltás	elleni_védőoltás
egészségügyi dolgozó	egészségügyi_dolgozó
kinai vakcina	kinai_vakcina
ember élet	ember_élet
oltási könyv	oltási_könyv
elleni vakcina	elleni_vakcina
oltás ellenes	oltás_ellenes
védő oltás	védő_oltás
magyar kormány	magyar_kormány
bcg oltás	bcg_oltás
korona vírus	korona_vírus
oltó anyag	oltó_anyag
eü dolgozó	eü_dolgozó
idős ember	idős_ember
egészséges ember	egészséges_ember
c vitamin	c_vitamin
magyar nép	magyar_nép
két hét	két_hét
kijárási tilalom	kijárási_tilalom
elmúlt év	elmúlt_év
karikó katalin	karikó_katalin
tömeges oltás	tömeges_oltás
kötelező védőoltás	kötelező_védőoltás
hosszú távú	hosszú_távú
krónikus betegség	krónikus_betegség
rövid idő	rövid_idő
kísérleti nyúl	kísérleti_nyúl
fidesz szavazó	fidesz_szavazó
első oltás	első_oltás
összeesküvés elmélet	összeesküvés_elmélet
operatív törzs	operatív_törzs
első kör	első_kör
vírus elleni	vírus_elleni
oltás mellékhatás	oltás_mellékhatás
hosszú táv	hosszú_táv
vakcina mellékhatás	vakcina_mellékhatás
normális élet	normális_élet
emberi jog	emberi_jog
millió adag	millió_adag
vakcina gyártó	vakcina_gyártó
influenza vírus	influenza_vírus
müller cecília	müller_cecília
vakcina beadás	vakcina_beadás
második hullám	második_hullám
sima influenza	sima_influenza
koronavírus elleni	koronavírus_elleni
házi orvos	házi_orvos
allergiás reakció	allergiás_reakció
influenza járvány	influenza_járvány
magyar vakcina	magyar_vakcina
kormány tag	kormány_tag
második oltás	második_oltás
engedélyezett vakcina	engedélyezett_vakcina
nyugati vakcina	nyugati_vakcina
mellék hatás	mellék_hatás
fertőzött szám	fertőzött_szám
gyártó felelősség	gyártó_felelősség
orosz oltás	orosz_oltás
tíz év	tíz_év
pcr teszt	pcr_teszt
oltás beadás	oltás_beadás
influenza védőoltás	influenza_védőoltás
idős beteg	idős_beteg
két év	két_év
két hónap	két_hónap
oltási igazolás	oltási_igazolás
idős krónikus	idős_krónikus
szabad akarat	szabad_akarat
enyhe tünet	enyhe_tünet
halálozási arány	halálozási_arány
legyengített vírus	legyengített_vírus
covi vakcina	covi_vakcina
súlyos mellékhatás	súlyos_mellékhatás
d vitamin	d_vitamin
hosszútávú mellékhatás	hosszútávú_mellékhatás
napi szint	napi_szint
két nap	két_nap
körzeti orvos	körzeti_orvos
vakcina kifejlesztés	vakcina_kifejlesztés
biztonságos vakcina	biztonságos_vakcina
cili néni	cili_néni
magyar orvos	magyar_orvos
hosszú idő	hosszú_idő
kínai oltás	kínai_oltás
idős otthon	idős_otthon
halott szám	halott_szám
kubatov lista	kubatov_lista
vakcina hatás	vakcina_hatás
európai unió	európai_unió
orosz rulett	orosz_rulett
európai gyógyszerügynökség	európai_gyógyszerügynökség
covi oltás	covi_oltás
vakcina tesztelés	vakcina_tesztelés
jövő hét	jövő_hét
orosz oltóanyag	orosz_oltóanyag
gyógyszer mellékhatás	gyógyszer_mellékhatás
elhunytak szám	elhunytak_szám
orvosi ellátás	orvosi_ellátás
klinikai vizsgálat	klinikai_vizsgálat
veszélyes vírus	veszélyes_vírus
hosszútávú hatás	hosszútávú_hatás
vakcina beszerzés	vakcina_beszerzés
emberi élet	emberi_élet
harmadik hullám	harmadik_hullám
kísérleti alany	kísérleti_alany
választási lehetőség	választási_lehetőség
amerikai vakcina	amerikai_vakcina
halálos vírus	halálos_vírus
covi elleni	covi_elleni
orbán kormány	orbán_kormány
maszk viselés	maszk_viselés
emberi szervezet	emberi_szervezet
covid vakcina	covid_vakcina
súlyos beteg	súlyos_beteg
gyártó cég	gyártó_cég
pozitív teszt	pozitív_teszt
kisérleti nyúl	kisérleti_nyúl
egészségügy dolgozó	egészségügy_dolgozó
két oltás	két_oltás
politikai kérdés	politikai_kérdés
moderna vakcina	moderna_vakcina
vakcina gyártás	vakcina_gyártás
magyar hatóság	magyar_hatóság
fertőző betegség	fertőző_betegség
kínai oltóanyag	kínai_oltóanyag
magyar szakember	magyar_szakember
kötelező vakcina	kötelező_vakcina
beoltott ember	beoltott_ember
felnőtt ember	felnőtt_ember
általános iskola	általános_iskola
eu engedélyezett	eu_engedélyezett
zsák krumpli	zsák_krumpli
vakcina fejlesztés	vakcina_fejlesztés
negatív teszt	negatív_teszt
első adag	első_adag
elölt vírus	elölt_vírus
oltási igazolvány	oltási_igazolvány
covi osztály	covi_osztály
első hullám	első_hullám
hónap védettség	hónap_védettség
európai ország	európai_ország
oltási hajlandóság	oltási_hajlandóság
klinikai teszt	klinikai_teszt
professzor asszony	professzor_asszony
eu vakcina	eu_vakcina
önkéntes oltás	önkéntes_oltás
sabin csepp	sabin_csepp
halálozási ráta	halálozási_ráta
minimum év	minimum_év
kínai szar	kínai_szar
fél óra	fél_óra
vírus terjedés	vírus_terjedés
hatásos vakcina	hatásos_vakcina
oltás hatás	oltás_hatás
magyar állampolgár	magyar_állampolgár
elleni oltas	elleni_oltas
rossz hír	rossz_hír
covid oltás	covid_oltás
influenza vakcina	influenza_vakcina
távú mellékhatás	távú_mellékhatás
gulyás gergely	gulyás_gergely
fekete himlő	fekete_himlő
elleni oltóanyag	elleni_oltóanyag
vírus tagadó	vírus_tagadó
ruszki vakcina	ruszki_vakcina
lehetséges mellékhatás	lehetséges_mellékhatás
eu engedély	eu_engedély
régi élet	régi_élet
három hónap	három_hónap
kötelező maszk	kötelező_maszk
határ túli	határ_túli
nemzeti konzultáció	nemzeti_konzultáció
első vakcina	első_vakcina
távú hatás	távú_hatás
miniszterelnök úr	miniszterelnök_úr
féle vakcina	féle_vakcina
elleni védekezés	elleni_védekezés
súlyos betegség	súlyos_betegség
kifejlesztett vakcina	kifejlesztett_vakcina
mrns vakcina	mrns_vakcina
teszt alany	teszt_alany
kutató orvos	kutató_orvos
magyar tudós	magyar_tudós
önkéntes alap	önkéntes_alap
elegendő vakcina	elegendő_vakcina
halálos áldozat	halálos_áldozat
covid elleni	covid_elleni
szputnyik v	szputnyik_v
oltás pont	oltás_pont
kísérleti patkány	kísérleti_patkány
milliárd forint	milliárd_forint
oltás hely	oltás_hely
ingyenes oltás	ingyenes_oltás
magyar kutató	magyar_kutató
desztillált víz	desztillált_víz
covidos beteg	covidos_beteg
öt év	öt_év
nobel díj	nobel_díj
oltási kedv	oltási_kedv
kijárási korlátozás	kijárási_korlátozás
rossz helyzet	rossz_helyzet
egészségügyi ellátás	egészségügyi_ellátás
mutáns vírus	mutáns_vírus
szlávik doktor	szlávik_doktor
teszt vakcina	teszt_vakcina
szakember vélemény	szakember_vélemény
örök élet	örök_élet
erős immunrendszer	erős_immunrendszer
kamu oltás	kamu_oltás
világ járvány	világ_járvány
kronikus beteg	kronikus_beteg
gyenge immunrendszer	gyenge_immunrendszer
élő adás	élő_adás
orvosi kamara	orvosi_kamara
szezonális influenza	szezonális_influenza
hajrá magyarország	hajrá_magyarország
kész vakcina	kész_vakcina
vakcina kérdés	vakcina_kérdés
magyar állam	magyar_állam
egészségi állapot	egészségi_állapot
vakcina útlevél	vakcina_útlevél
vírus járvány	vírus_járvány
autoimmu betegség	autoimmu_betegség
idős korosztály	idős_korosztály
jelenlegi helyzet	jelenlegi_helyzet
pfizer oltás	pfizer_oltás
fake news	fake_news
teszt eredmény	teszt_eredmény
ast zeneca	ast_zeneca
taj szám	taj_szám
magyar egészségügy	magyar_egészségügy
miniszter elnök	miniszter_elnök
komoly mellékhatás	komoly_mellékhatás
magas vérnyomás	magas_vérnyomás
spanyol nátha	spanyol_nátha
vakcina hatékonyság	vakcina_hatékonyság
intenzív osztály	intenzív_osztály
varga judit	varga_judit
jelen eset	jelen_eset
ember beoltás	ember_beoltás
jövő év	jövő_év
kamu hír	kamu_hír
adófizető pénz	adófizető_pénz
hülye gyerek	hülye_gyerek
kossuth rádió	kossuth_rádió
oltási program	oltási_program
eu ország	eu_ország
kevés vakcina	kevés_vakcina
vakcina előállítás	vakcina_előállítás
influenza szezon	influenza_szezon
jelen helyzet	jelen_helyzet
harmadik fázis	harmadik_fázis
gazdasági válság	gazdasági_válság
környező ország	környező_ország
uniós ország	uniós_ország
feltételes mód	feltételes_mód
enyhe lefolyású	enyhe_lefolyású
ember jog	ember_jog
olto anyag	olto_anyag
veszettség elleni	veszettség_elleni
online oktatás	online_oktatás
európai bizottság	európai_bizottság
keleti vakcina	keleti_vakcina
súlyos szövődmény	súlyos_szövődmény
autoimmun beteg	autoimmun_beteg
orosz vakcinat	orosz_vakcinat
orbán család	orbán_család
jóváhagyott vakcina	jóváhagyott_vakcina
müller cecilia	müller_cecilia
többi vakcina	többi_vakcina
köz oltás	köz_oltás
fidesz hívő	fidesz_hívő
kísérleti fázis	kísérleti_fázis
ellenzéki politikus	ellenzéki_politikus
beteg idős	beteg_idős
oltás igazolás	oltás_igazolás
előző év	előző_év
többi oltás	többi_oltás
súlyos tünet	súlyos_tünet
káros hatás	káros_hatás
vírus ellenszer	vírus_ellenszer
második adag	második_adag
politikai nyomás	politikai_nyomás
szlávik jános	szlávik_jános
kamu profil	kamu_profil
fidesz kormány	fidesz_kormány
járvány elleni	járvány_elleni
sárga csillag	sárga_csillag
anafilaxiás sokk	anafilaxiás_sokk
magyar lakosság	magyar_lakosság
pár év	pár_év
másfél év	másfél_év
egyesült államok	egyesült_államok
jelen pillanat	jelen_pillanat
utóbbi év	utóbbi_év
oltás párti	oltás_párti
ellenzéki párt	ellenzéki_párt
gyermekbénulás elleni	gyermekbénulás_elleni
kórházi ellátás	kórházi_ellátás
megbízható vakcina	megbízható_vakcina
oltás kérdés	oltás_kérdés
biztonságos oltás	biztonságos_oltás
gyengített vírus	gyengített_vírus
pfizer biontech	pfizer_biontech
teszt pozitív	teszt_pozitív
mrns alapú	mrns_alapú
rendelkezés álló	rendelkezés_álló
covid osztály	covid_osztály
három hét	három_hét
nyáj immunitás	nyáj_immunitás
kamu oldal	kamu_oldal
influenza oltas	influenza_oltas
halálozási adat	halálozási_adat
háziorvosi rendelő	háziorvosi_rendelő
veszélyeztetett korosztály	veszélyeztetett_korosztály
ezer halott	ezer_halott
oltási sorrend	oltási_sorrend
orvosi rendelő	orvosi_rendelő
halálos betegség	halálos_betegség
szijjártó péter	szijjártó_péter
ember kísérlet	ember_kísérlet
maszk használat	maszk_használat
kínai cucc	kínai_cucc
hatékony vakcina	hatékony_vakcina
kísérleti vakcina	kísérleti_vakcina
statisztikai adat	statisztikai_adat
kevés ember	kevés_ember
egészségügyi miniszter	egészségügyi_miniszter
oltott ember	oltott_ember
beteg szám	beteg_szám
tiszti főorvos	tiszti_főorvos
emberi butaság	emberi_butaság
jó vakcina	jó_vakcina
egészségügyi rendszer	egészségügyi_rendszer
gyártási folyamat	gyártási_folyamat
covi vírus	covi_vírus
alapvető élelmiszer	alapvető_élelmiszer
beteg gyerek	beteg_gyerek
novák hunor	novák_hunor
magyar nemzet	magyar_nemzet
biológiai fegyver	biológiai_fegyver
következő év	következő_év
eu tagállam	eu_tagállam
tüdőgyulladás elleni	tüdőgyulladás_elleni
covid vírus	covid_vírus
kórházi kezelés	kórházi_kezelés
oltási bizonyítvány	oltási_bizonyítvány
köz vakcina	köz_vakcina
vak cina	vak_cina
birka nép	birka_nép
hiteles tájékoztatás	hiteles_tájékoztatás
kevesebb ember	kevesebb_ember
rossz vakcina	rossz_vakcina
vakcina teszt	vakcina_teszt
eu tag	eu_tag
soros györgy	soros_györgy
kórházi dolgozó	kórházi_dolgozó
vakcina gyár	vakcina_gyár
száz év	száz_év
alap betegség	alap_betegség
parlamenti képviselő	parlamenti_képviselő
gyógyszergyártó cég	gyógyszergyártó_cég
gates féle	gates_féle
káros mellékhatás	káros_mellékhatás